SO ./textures/brick.xpm
NO ./textures/wood.xpm
WE ./textures/metal.xpm
EA ./textures/index.xpm

F 000,000,000
C 70,70,70

        1111111111111111111111111
        1000000000110000000000001
        1011000001110000000000001
        1001000000000000000000001
111111111011000001110000000000001
100000000011000001110111111111111
11110111111111011100000010001
11110111111111011101010010001
11000000110101011100000010001
10000000000000000000000010001
1100000000000000000000010001
1100001100000000000000000010001
110000110000000N000000000010001
110000000000000000000000010001
110000000000000000000000010001
100000000000000000001010010001
11000001110101011111011110001
11110111 1110101 101111010001
11111111 1111111 111111111111
