SO ./textures/brick.xpm
NO ./textures/wood.xpm
WE ./textures/metal.xpm
EA ./textures/stone.xpm

F 0,255,0
C 0,0,255

1111111 11111111111111111111
111111110000000000000011111
100000000000000000111000100001
11000000000001000W0000000000000001111
10000111111100000000000111111
11111110000000000000000000001
11110000000000110000000000011
1                            1
110000000000011110000000000011
100000000000111000000000000011
110000000000111111111000000000001111
110000000001111000000000000111
111111111111111111111111111111111
